

comment
$ - Commenting
? - Commenting
> - Commenting
comment - Commenting

basic
version - Version
output - Console Output
input - Console Input
end - Exit

debug
restore - Allows Code Execution Again
error - Creates Error
warn - Creates Warning

variable
meta - Meta Data Variable
var - Variable
alg - Function
result - Returns Values

operator
add - Adds Given Values
subtract - Subtracts Given Two Values
multiply - Multiplies Given Values
divide - Divides Given Two Values
power - Raises First Value To Power Of Second Value
info - Variable/Value Type

logic
check - If-Else Statement
condition - Returns Objective Value Of Given Values And Conditions

loop
repeat - Statically Repeats Given Function
loop - Dynamically Loops Given Function On Basis Of Given Condition

external resource
module - Imports And Partially Executes Module

iterable
count - Returns Length Of Value
insert - Inserts A Second Given Value Inside Of The First Given Value
remove - Removes The Second Value From First Many Value Third Given Value Times
delete - Removes The Second Value Index Character From First Value

time
reset_tick - Resets Engine Tick Count
pause_tick - Pauses Engine Ticking
resume_tick - Resumes Engine TIcking
get_tick - Gets Engine Tick Count

console
clear - Clears Output Console
console - Executes Given Value As Command In Running Console

file
read - Reads A File Named As Given Value
write - Writes Second Value In A File Named As First Value, Creates If Not Found

